2-4-4-4-2-4-4-2-2-4-4-2-2
2-2-4-2-2-4-2-4-2-4-2-4-2
2-2-4-2-2-4-2-4-2-4-4-2-2
2-2-4-2-2-4-4-2-2-4-2-2-2
0-0-0-0-0-0-0-0-0-0-0-0-0
0-1-4-1-0-3-3-3-0-1-4-1-0
0-1-4-1-0-0-0-0-0-1-4-1-0
0-0-0-0-0-4-4-4-0-0-0-0-0
0-0-0-0-0-4-5-4-0-0-0-0-0