0-4-0-4-0-4-0-4-0-4-0-4-0
0-4-3-4-0-4-0-4-0-4-3-4-0
0-4-3-4-0-4-0-4-0-4-3-4-0
0-4-3-4-0-4-0-4-0-4-3-4-0
0-4-0-4-0-4-0-4-0-4-0-4-0
0-0-0-0-0-2-2-2-0-0-0-0-0
0-1-0-1-0-0-0-0-0-1-0-1-0
0-4-0-4-0-4-4-4-0-4-0-4-0
0-0-0-0-0-4-5-4-0-0-0-0-0